WE ./assets/textures/parede7.xpm
EA ./assets/textures/parede8.xpm
NO ./assets/textures/chao3.xpm
SO ./assets/textures/chao2.xpm

F 120,120,120
C 5,204,255

111111111111111
100000100111001
10000011111111111111111111
10000010000000000000010001
10000010000011110001000001
10000010000000000000010001
11101111111011111111110001
110000110000001      10001
100000010000001      10001
100000010000001      10S01
10000000000000111111111011111111111
10000001000000100000000000000000001
100000010000001000000000000000000011111
110000110000001001110000000000110010001
111111111111111001000000000000010010001
              1000000000000000000010001
              1000001111111111110010001
              1000000000000000000000001
              1000000000000000000010001
              1000000011111111110010001
              1001000000000000010010001
              1001100000000000110010001
              1000000011111111110010001
              1000000000000000000010001
              1111111111111111111110001
                                  10001
                               11110001111
                               10000000001
   1111111111111               10000000001
   1000000000001               10000000001
   1000000000001               10000000001
   1000000000001               10000000001
   1000000000001               10000000001
   1000000000001               10000000001
   10011111111111111111111     11111011111
   10000000000000000000001       100001
   11110000000000000000001       100001
      10000000000000000001       100001
  1111100000000000011101111111111100001
  1000000000000000010000000000000000001
  1000100000000000010000000000000000001
  1000100000000000010000011110000000001
  1000111111011111110000000000000000001
  111111111111    111111111111111111111
