EA ./assets/theme/parede1.xpm
WE ./assets/theme/parede2.xpm
SO ./assets/theme/parede6.xpm
NO ./assets/theme/parede8.xpm
F ./assets/theme/chao.xpm
C 100,20,20

11111111111111111111111111111111111
1N000B00010000B0000G000001H0P000001
100U00Z00100U00Z000B00U00L00G00H0P1
10000000010B0000U0000Z000L0P00H0001
111111D11111111111D1111111111111111
1000000000000000000000000000B00G001
10B0U000Z00B00000Z000U00B00000Z0U01
1111111D111111111D111111111111D1111
100000000100G00000000000100000000K1
100Z0B0U0100P000B000X000100U0B0Z001
10000000010000000B000000100Z0U0Z0U1
11111D111111111D11111111111111D1111
100G00000000000000000B0000000000001
100Z00U0B00U00Z00B0000U00B00Z00U0B1
10B0000000B00G00000P00000000B000001
1000U00Z0000U00B0000Z00U00Z000U00Z1
11111111111111111111111111111111111
