EA ./assets/textures/ea.xpm
WE ./assets/textures/we.xpm
SO ./assets/textures/so.xpm
NO ./assets/textures/no.xpm

F 100,100,100
C 30,30,80

11111111111
10000000001
10000B00001
10000000001
10000N00001
11111111111
