EA ./assets/theme/parede1.xpm
WE ./assets/theme/parede2.xpm
SO ./assets/theme/parede6.xpm
NO ./assets/theme/parede8.xpm

F ./assets/theme/chao.xpm
C 100,20,20

11111111111111111111111111111111111111111
1S000000000100000001000000010000000000001
100000000001000M0001000M00010000000000001
11111D1111110000000D000000011111D11111111
10000000000100000001000000010000000000001
10000000000D111D1111111D111D000M000000001
1000M000000100000000000000010000000000001
10000000000000000000000000000000000000001
11111D111111000011111110000111111D1111111
10000000000D0000D00000D0000D0000000000001
1000M00000010000100B00100001000M000000001
1000000000010000D00000D000010000000000001
11111D111111000011111110000111111D1111111
10000000000000000000000000000000000000001
1000M0000000000000000000000000000M0000001
11111111111111111111111111111111111111111
