EA ./assets/theme/parede1.xpm
WE ./assets/theme/parede2.xpm
SO ./assets/theme/parede6.xpm
NO ./assets/theme/parede8.xpm

F ./assets/theme/chao.xpm
C 100,20,20

11111111111111111111111111111111111111111
1S00H00G000100P00K010B0000010K00G00H00001
10B0000P0001000Z0001000Z000100P0000B00001
11111D11111100B0000D00G000011111D11111111
100G0000H00100000K0100000001000H000P00K01
10000000B00D111D1111111D111D000U000000B01
1000Z000000100G00H0000G00H0100000Z0000001
100P000000000B00000P00000B00000000000G001
11111D111111000011111110000111111D1111111
100H000G000D0B00D00P00D00B0D00G000H000001
1000U000P0010000100X00100001000U000P00001
10B000000K0100P0D00X00D0P0010K0000000B001
11111D111111000011111110000111111D1111111
100000H00000000000H0H0000000000000H000001
1000X000B00G00P000000000P00G00B000X000001
11111111111111111111111111111111111111111
