WE ./assets/textures/parede7.xpm
EA ./assets/textures/parede8.xpm
NO ./assets/textures/chao3.xpm
SO ./assets/textures/chao2.xpm

F ./assets/textures/grama1.xpm
C 5,204,255

111111111111111111111111111111111111111111111111111111
1000000000000D0000000000000000000000D000000000D00000001
101111111111111111111111111111111111111111111111111101
101000000000000000000000000000000000000000000000000101
101000111111111111111111111111111111111111111110000101
101000100000000000000000000000000000000000000010000101
101000100111111111111111111111111111111111111010000101
101000100100000000000000000000000000000000001010000101
101000100101111111111111111111111111111111101010000101
101000100101000000000000000000000000000001101010000101
101000100101011111111111111111111111111101101010000101
101000100101010000000000000000000000001101101010000101
101000100101010111111111111111111111101101101010000101
101000100101010100000000000000000001101101101010000101
101000100101010101111111111111111101101101101010000101
101000100101010101000000000000001101101101101010000101
101000100101010101011111111111101101101101101010000101
101000100101010101010000000001101101101101101010000101
101000100101010101010111111101101101101101101010000101
101000100101010101010100000001101101101101101010000101
101000100101010101010101111111101101101101101010000101
101000100101010101010101000000001101101101101010000101
101000100101010101010101010000000001101101101010000101
101000100101010101010101010111111101101101101010000101
101000100101010101010101011111111101101101101010000101
101000100101010101010101010100000001101101101010000101
101000100101010101010101010101111111101101101010000101
101000100101010101010101010101000000001101101010000101
101000100101010101010101010101011111111101101010000101
101000100101010101010101010101010000000001101010000101
101000100101010101010101010101010111111111101010000101
101000100101010101010101010101010100000000001010000101
101000100101010101010101010101010101111111101010000101
101000100101010101010101010101010101000001101010000101
101000100101010101010101010101010101011101101010000101
101000100101010101010101010101010101010001101010000101
101000100101010101010101010101010101010111101010000101
101000100101010101010101010101010101010100001010000101
101000100101010101010101010101010101010101111010000101
101000100101010101010101010101010101010101000010000101
101000100101010101010101010101010101010101011110000101
101000100101010101010101010101010101010101000000000101
101000100101010101010101010101010101010101111111110101
101000100101010101010101010101010101010100000000010101
101000100101010101010101010101010101010111111111010101
101000100101010101010101010101010101010000000001010101
101000100101010101010101010101010101011111111101010101
101000100101010101010101010101010101000000000001010101
101000100101010101010101010101010101111111111111010101
101000100101010101010101010101010100000000000000010101
101000100101010101010101010101010111111111111111110101
101000100101010101010101010101010000000000000000000101
101000100101010101010101010101011111111111111111110101
101000100101010101010101010101000000000000000000010101
101000100101010101010101010101111111111111111110010101
101000100101010101010101010100000000000000000010010101
101000100101010101010101010111111111111111111010010101
101000100101010101010101010000000000000000001010010101
101000100101010101010101011111111111111111101010010101
101000100101010101010101000000000000000001101010010101
101000100101010101010101111111111111111101101010010101
101000100101010101010100000000000000001101101010010101
101000100101010101010111111111111111101101101010010101
101000100101010101010000000000000001101101101010010101
101000100101010101011111111111111101101101101010010101
101000100101010101000000000000001101101101101010010101
101000100101010101111111111111101101101101101010010101
101000100101010100000000000001101101101101101010010101
101000100101010111111111111101101101101101101010010101
101000100101010000000000000001101101101101101010010101
101000100101011111111111111111101101101101101010010101
101000100101000000000000000000001101101101101010010101
101000100101111111111111111111111101101101101010010101
101000100100000000000000000000000001101101101010010101
101000100111111111111111111111111111101101101010010101
101000100000000000000000000000000000001101101010000101
101000111111111111111111111111111111111101101110000101
101000000000000000000000000000000000000001100000000101
101111111111111111111111111111111111111111111111111101
1000000000000D00000000000000000D0000000000D000000000N1
111111111111111111111111111111111111111111111111111111
