WE ./assets/textures/parede7.xpm
EA ./assets/textures/parede8.xpm
NO ./assets/textures/chao3.xpm
SO ./assets/textures/chao2.xpm

F ./assets/textures/grama1.xpm
C 5,204,255

11111111111111111111111111111111111111111111111111111111111
10000000000000000000000000000000000000000000000000000000001
10111111111111111111111111111111111111111111111111111111101
10100000000000000000000000000000000000000000000000000000101
10100000000000000000000000000000000000000000000000000000101
10100011111111111111111111111111111111111111111111111000101
10100010000000000000000000000000000000000000000000001000101
10100010000000000000000000000000000000000000000000001000101
10100010011111111111111111111111111111111111111111101000101
10100010010000000000000000000000000000000000000000101000101
10100010010000000000000000000000000000000000000000101000101
10100010010111111111111111111111111111111111111110101000101
10100010010100000000000000000000000000000000000110101000101
10100010010100000000000000000000000000000000000110101000101
10100010010101111111111111111111111111111111110110101000101
10100010010101000000000000000000000000000000110110101000101
10100010010101000000000000000000000000000000110110101000101
10100010010101011111111111111111111111111110110110101000101
10100010010101010000000000000000000000000110110110101000101
10100010010101010000000000000000000000000110110110101000101
10100010010101010111111111111111111111110110110110101000101
10100010010101010100000000000000000000110110110110101000101
10100010010101010100000000000000000000110110110110101000101
10100010010101010101111111111111111110110110110110101000101
10100010010101010101000000000000000110110110110110101000101
10100010010101010101000000000000000110110110110110101000101
10100010010101010101011111111111110110110110110110101000101
10100010010101010101010000000000000110110110110110101000101
10100010010101010101010000000000000110110110110110101000101
10100010010101010101010111111111111110110110110110101000101
10100010010101010101010100000000000000110110110110101000101
10100010010101010101010100000000000000110110110110101000101
10100010010101010101010101111111111111110110110110101000101
10100010010101010101010101000000000000000110110110101000101
10100010010101010101010101000000000000000110110110101000101
10100010010101010101010101011111111111111110110110101000101
10100010010101010101010101010000000000000000110110101000101
10100010010101010101010101010000000000000000110110101000101
10100010010101010101010101010111111111111111110110101000101
10100010010101010101010101010100000000000000000110101000101
10100010010101010101010101010100000000000000000110101000101
10100010010101010101010101010101111111111111111110101000101
10100010010101010101010101010101000000000000000000101000101
10100010010101010101010101010101000000000000000000101000101
10100010010101010101010101010101011111111111111111101000101
10100010010101010101010101010101010000000000000000101000101
10100010010101010101010101010101010000000000000000101000101
10100010010101010101010101010101010111111111111110101000101
10100010010101010101010101010101010100000000000110101000101
10100010010101010101010101010101010100000000000110101000101
10100010010101010101010101010101010101111111110110101000101
10100010010101010101010101010101010101000000000110101000101
10100010010101010101010101010101010101000000000110101000101
10100010010101010101010101010101010101011111111110101000101
10100010010101010101010101010101010101010000000000101000101
10100010010101010101010101010101010101010000000000101000101
10100010010101010101010101010101010101010111111111101000101
10100010010101010101010101010101010101010100000000101000101
10100010010101010101010101010101010101010100000000101000101
10100010010101010101010101010101010101010101111110101000101
10100010010101010101010101010101010101010101000000101000101
10100010010101010101010101010101010101010101000000101000101
10100010010101010101010101010101010101010101011111101000101
10100010010101010101010101010101010101010101000000001000101
10100010010101010101010101010101010101010101000000001000101
10100010010101010101010101010101010101010101111111111000101
10100010010101010101010101010101010101010100000000000000101
10100010010101010101010101010101010101010100000000000000101
10100010010101010101010101010101010101010111111111111110101
10100010010101010101010101010101010101010000000000000000101
10100010010101010101010101010101010101010000000000000000101
10100010010101010101010101010101010101011111111111111110101
10100010010000000000000000000000000000000000000000000000101
10100010000000000000000000000000000000000000000000000000101
10100011111111111111111111111111111111111111111111111000101
10100000000000000000000000000000000000000000000000000000101
1010000000000000000000000000000000000000000000000000000N01
11111111111111111111111111111111111111111111111111111111111
