EA ./assets/textures/ea.xpm
WE ./assets/textures/we.xpm
SO ./assets/textures/so.xpm
NO ./assets/textures/no.xpm

F 220,100,0
C 225,30,0

111111111
1E000D001
101110001
111111111
