EA ./assets/textures/ea.xpm
WE ./assets/textures/we.xpm
SO ./assets/textures/so.xpm
NO ./assets/textures/no.xpm
F 100,100,100
C 50,50,80

        1111111111111
        1000000000001
        1000M0000M001
        10000000000M1
        1000000D00001
        1N0000010M001
        1000000100001
        1111111111111
