EA ./assets/textures/themes/parede1.xpm
WE ./assets/textures/themes/parede2.xpm
SO ./assets/textures/themes/parede4.xpm
NO ./assets/textures/themes/parede4.xpm

F ./assets/textures/grama1.xpm
C 50,50,80

1111111111111
1000000000001
1000M0000M001
10000G00000M1
1000000D0P001
1N0K00010M001
1000000100001
1111111111111
