NO ./assets/tatame_north_texture.xpm
SO ./assets/tatame_south_texture.xpm
WE ./assets/tatame_west_texture.xpm
EA ./assets/tatame_east_texture.xpm

F 220,100,0
C 225,30,0

1111
1N01
12A1
1111
