EA ./assets/textures/ea.xpm
WE ./assets/textures/we.xpm
SO ./assets/textures/so.xpm
NO ./assets/textures/no.xpm

F 120,120,120
C 180,200,255

1111111111
1100000011
1000000001
1010000001
1000011001
1000000001
10010N0001
1000000001
1100000011
1111111111
