EA ./assets/theme/parede1.xpm
WE ./assets/theme/parede2.xpm
SO ./assets/theme/parede4.xpm
NO ./assets/theme/parede4.xpm

F ./assets/theme/grama1.xpm
C 30,30,80

111111111111111111111111111111111
1S0001000Z0HM00100B00001000Z00001
101001000U000G010000000D000000001
10000L0001111D1100000001111111D11
100M010001000M0100P00001000000001
1000K1111100Z0010000U0010000M0001
10000000010000010000000DM00000001
111111D11111111111111111111111001
100000U00000Z000000H0000M00001001
100P00000000000000000000000B0D001
111111111111111111D11111111111001
100G000U0000000100000001000H00001
100000000000Z0D000U00010000000001
1000000111111111000M0001111111111
10000001000000010000000DZ00000001
111D1111000P0001000G00010000M0001
10U000010000000111D11111000000001
1000M00D0000000000000001000000001
100B0001000H0000000P000D000G00001
111111111111111111111111111111111
