EA ./assets/theme/parede1.xpm
WE ./assets/theme/parede2.xpm
SO ./assets/theme/parede6.xpm
NO ./assets/theme/parede8.xpm

F ./assets/theme/chao.xpm
C 100,20,20

1111111111111111111111111
1E0000000B001000B00000001
100000U00000100000U000001
10B000000000D000000000B01
111111D11111111111D111111
1000000010000000100000001
100000001000H000100000001
100B0000L00GHG00L000B0001
100000001000H000100000001
11111111111111111111D1111
1000000000001000000000001
100000000000D000000000001
10B0011111111111111100B01
1000010000000000000100001
1000010U0Z00000Z0U0100001
1000010Z000U0U000Z0100001
10000D0000U00U0000KD00001
1000010Z000U0U000Z0100001
1000010U0Z00000Z0U0100001
1000011111111111111100001
1000000000001000000000001
1000000000001000000000001
1000B000000010000000B0001
1110000X00001000000000111
1111111111111111111111111
