EA ./assets/theme/parede1.xpm
WE ./assets/theme/parede2.xpm
SO ./assets/theme/parede6.xpm
NO ./assets/theme/parede8.xpm
F ./assets/theme/chao.xpm
C 100,20,20

1111111111111111111111
1S0000001H0P0100000001
100B0000L0G00L00U00B01
100M0000L00H010000Z001
1111D1111111111111D111
1000000000000000000001
10Z00001111D111100B001
10M00U010000000100U001
100B00010Z0K0U01000001
1111111100M0Z00100Z001
1000000D0000000100M0B1
1111111111111111111111
