EA ./assets/theme/parede1.xpm
WE ./assets/theme/parede2.xpm
SO ./assets/theme/parede6.xpm
NO ./assets/theme/parede8.xpm
F ./assets/theme/chao.xpm
C 100,20,20

1111111111111111111111111111
1E000B001000000000001H0P0001
100M00Z0100B00U0M000L00G00H1
1000000010Z0M0000B00L0P000P1
1111D11111111D11111111111111
10000000000000000000000B0001
100U00B00000M00Z00B000U00M01
1111D1111111111111111D111111
10000000100000000000000000K1
10Z00000100M0Z000U0000M000Z1
10M00B00100B0U0M0B000Z00B0M1
1000000010000000000000U00001
100U00001000Z00M000000000001
1111111111111111111111111111
