EA ./assets/theme/parede1.xpm
WE ./assets/theme/parede2.xpm
SO ./assets/theme/parede4.xpm
NO ./assets/theme/parede4.xpm

F ./assets/theme/grama1.xpm
C 30,30,80

111111111111111111111111111111111
1N0001000000000100000001000M00001
100001000000000100000001000000001
1000010001111D11000K0001111111D11
100M01000100000100000001000000001
100001111100M0010000M0010000M0001
100000000100000100000001000000001
111111D11111111111111111111111001
100000000000M00000000000000001001
100000000000000000000K00000001001
111111111111111111D11111111111001
1000000M0000000100000001000000001
100000000000000100000001000K00001
100K000111111111000M0001111111111
100000010000000100000001000000001
111D1111000O0001000000010000M0001
100000010000000111D11111000000001
1000M0010000000000000001000000001
100000010000000000000001000000001
111111111111111111111111111111111
