EA ./assets/theme/parede8.xpm
WE ./assets/theme/parede9.xpm
SO ./assets/theme/parede6.xpm
NO ./assets/theme/parede6.xpm

F ./assets/theme/chao.xpm
C 50,20,20

111111111111111111111111111111111111111
1S00000010000Z0010000U0010B000001000001
1000G000D00H00001000P000D00000001000001
11111D111000K00011111D111000P0001000K01
100H000010000B00D00000000000H000D000001
1000M0001111111111111111111111D11111D11
1000000010000Z0000G00100000000000000001
100P0000D00000000000010000U000B000Z0001
11D111111111D11111D111000H0000000000001
100000000000000000000D0000G000P00000001
100B00G000H000P0000001111D1111111111111
1111111111111111111D110000000B000000001
1000K000000U000000000D0000P0000H0000001
10000G00M000000Z000001000Z00000G00K0001
111111111111111111111111111111111111111
