EA ./assets/theme/parede1.xpm
WE ./assets/theme/parede2.xpm
SO ./assets/theme/parede4.xpm
NO ./assets/theme/parede4.xpm

F ./assets/theme/grama1.xpm
C 30,30,80

111111111111111111111111111111111
1S0001000M00M00100000001000M00001
100001000M0000010000000D000000001
10000D0001111D11000K0001111111D11
100M010001000M0100000001000000001
100001111100M0010000M0010000M0001
10000000010000010000000DM00000001
111111D11111111111111111111111001
100000M00000M00000000000M00001001
100000000000000000000K0000000D001
111111111111111111D11111111111001
1000000M0000000100000001000000001
100000000000000D000M0001000K00001
100K000111111111000M0001111111111
10000001000000010000000DM00000001
111D1111000O0001000000010000M0001
10M00M010000000111D11111000000001
1000M00D0000000000000001000000001
10000001000000000000000D000000001
111111111111111111111111111111111
