EA ./assets/theme/parede1.xpm
WE ./assets/theme/parede2.xpm
SO ./assets/theme/parede6.xpm
NO ./assets/theme/parede8.xpm
F ./assets/theme/chao.xpm
C 100,20,20

11111111111111111111111111111111
1S00B0000100000B000000001H0P0001
1000U0M0010Z0M000U00B000L00G00H1
10M0000001000B0Z000M0000L0P0H0P1
11111D11111111111111D11111111111
1000000000000000000000000000B001
10U00B0Z0000M00B000U0M00B00Z0001
111111D111111111D1111111111D1111
100000000100000000000000100000K1
100M0Z000100M0U0B0Z000M010U0B0Z1
10B000U00100B0000000U000100Z0M01
1111111D11111111D111111111111D11
10000000000000000000000000000001
10M0B0Z000U00B0M00Z00B0M000U0B01
100000M00000Z00000M00000Z0M00001
11111111111111111111111111111111
