EA ./assets/theme/parede1.xpm
WE ./assets/theme/parede2.xpm
SO ./assets/theme/parede6.xpm
NO ./assets/theme/parede8.xpm
F ./assets/theme/chao.xpm
C 100,20,20

111111111111111
1N0000100000K01
100M00100M00Z01
100000100000001
11D111111D11111
1000001H0P100M1
10M0Z0D0G0L0Z01
10000010H010M01
100000111110001
111111111111111
