EA ./assets/theme/parede1.xpm
WE ./assets/theme/parede2.xpm
SO ./assets/theme/parede6.xpm
NO ./assets/theme/parede8.xpm
F ./assets/theme/chao.xpm
C 100,20,20

1111111111111111111111111
1N00000100B000001H0P0H001
1000B0010U00M000L00G00001
100M0Z0100Z00U00L0P0H0001
1000000111111D11111111111
1111D11100000000000B00001
1000000000011D111000U0001
10Z0U00000010000100Z0M001
100B0M0111110M001111D1111
100M000100000U000000000K1
10000Z0100B0Z00B000U0M001
1000B001000000000000000Z1
1111111111111111111111111
