EA ./assets/textures/ea.xpm
WE ./assets/textures/we.xpm
SO ./assets/textures/so.xpm
NO ./assets/textures/no.xpm

F ./assets/textures/grama1.xpm
C 30,30,80

111111111111111111111111111111111
100000000000000000000000000000001
100000000011111111111111000000001
100M0000001000000000000010000G001
10000000001000000000M000100000001
100000000010000000M00000100000001
111D11111110011111111111100000001
100000000000100000000000000000001
10000000000010000000M000000000001
100000000000100000000000000000001
100000000000100000000000000000001
100000000000111111111111D11111111
10000M000000000000000000000000001
100000000000000000000000000000001
1000000000000000M0000000000000001
100000000000000000000000000000001
111111111111111111111111111000001
100000000000000000000000001000001
100000000000000000000000001000001
100000000000000000000000001000001
100000000000000000000000001000001
100000000000111111111111111000001
100000000000100000000000000000001
100000000000100000000000000000001
100000000000100000000000000000001
100000000000100000000000000000001
1000000M000010000000000M000000001
100000000000100000000000000000001
100000000000100000000000000000001
100000000000100000000000000000001
100000000000100000000000000000001
100000000000100000000000000000001
100000000000111111111111111111111
100000000000000000000000000000001
100000000000000000000000000000001
10000G00000000000000000000000M001
100000000000000000000000000000001
111111111111111D11111111111111111
1000M0000000000000000000000000001
1000000000000000000M0000000000001
100000000000000000000000000000001
100000000000000000000000000000001
10000000000000000000000000000S001
111111111111111111111111111111111
