EA ./assets/theme/parede1.xpm
WE ./assets/theme/parede2.xpm
SO ./assets/theme/parede6.xpm
NO ./assets/theme/parede8.xpm
F ./assets/theme/chao.xpm
C 100,20,20

11111111111111111111
1W0000010000001H0P01
100B000100U000L0G001
100M0Z01000000L0H001
1000000111D111111111
111D1111000000000B01
1000000D00M0Z0000001
10B00U0100000011D111
1000M001111111100K01
1000000000000B10Z001
100Z0M000U000010U001
11111111111111111111
