EA ./assets/theme/parede1.xpm
WE ./assets/theme/parede2.xpm
SO ./assets/theme/parede6.xpm
NO ./assets/theme/parede8.xpm
F ./assets/theme/chao.xpm
C 100,20,20

111111111111111111
1E00001000001H0P01
100B0010M0Z0L0G001
100M00100000L0H001
111D111111D1111111
100000000000000B01
10Z000111D11100001
10M000100K0M10B0Z1
1000B010Z0M01000M1
111111111111111111
