EA ./assets/theme/parede1.xpm
WE ./assets/theme/parede2.xpm
SO ./assets/theme/parede6.xpm
NO ./assets/theme/parede8.xpm
F ./assets/theme/chao.xpm
C 100,20,20

111111111111
1S00001H00P1
100M00L0G001
100M00L000H1
100000111111
11D1111000M1
100000D00MK1
111111111111
