EA ./assets/theme/parede8.xpm
WE ./assets/theme/parede9.xpm
SO ./assets/theme/parede6.xpm
NO ./assets/theme/parede6.xpm

F ./assets/theme/chao.xpm
C 50,20,20

111111111111111111111111111111111111111
1S00000010000M0010000M001000000010000M1
100000001000000010000000100000001000001
11111D111000K00011111D111000O0001000K01
100000001000000000000000000000001000001
1000M0001111111111111111111111D11111D11
1000000010000M0000000100000000000000001
10000000100000000000010000M0000000M0001
11D111111111D11111D11100000000000000001
100000000000000000000100000000000000001
1000000000000000000001111D1111111111111
1111111111111111111D1100000000000000M01
1000K0000000000000000100000000000000001
10000000M000000M000001000M00000000K0001
111111111111111111111111111111111111111
