EA ./assets/theme/parede1.xpm
WE ./assets/theme/parede2.xpm
SO ./assets/theme/parede6.xpm
NO ./assets/theme/parede8.xpm
F ./assets/theme/chao.xpm
C 100,20,20

111111111111111111111111111111
1W00B000100000B0000001H0P00H01
100U00Z010M000U00M000L00G00P01
1000M000100Z0M0B0Z000L0H000H01
11111D1111111111D1111111111111
10000000000000000000000B000001
10M00B000U000M000B0Z00M000U001
11111D111111111111D111111D1111
1000000010000000000001000000K1
100Z0B00100U0M000Z00010M00Z0M1
10M000U01000B000B00U010B0U00B1
100B0Z0010M000Z000M001000M0Z01
10000000D000U000M0000D00000001
100U00M0100000B000Z0010Z0M0U01
111111111111111111111111111111
