NO ./assets/textures/comb2/tatame_north_texture.xpm
SO ./assets/textures/comb2/tatame_south_texture.xpm
WE ./assets/textures/comb2/tatame_west_texture.xpm
EA ./assets/textures/comb2/tatame_east_texture.xpm

F 49,45,21
C  135,206,225

1111111111111111111111111111111111111
				1110000111000001100000001   111
	11100100000011100000111001111111
111111110111111001111110000001001
1100111001    1101     1101101001
100000011111111000111111001111111111111111111111111111111
10111000000000S000000011111		111111		  1111111
101000000111111000111111101111111111111111111111111111111
1011100101    10001    1010100111
1010001101111111001111110010011 111111111111111	1111111111
101110110000100010001000000011011
10000000011000010010000100001 101
111111111111111111111111111111111
