NO ./assets/tatame_north_texture.xpm
SO ./assets/tatame_south_texture.xpm
WE ./assets/tatame_west_texture.xpm
EA ./assets/tatame_east_texture.xpm

F 120,120,120
C 180,200,255

11111111111111111111
11000000000000000011
10000000000000000001
10100000000000000001
10000010001000000001
10000N000001000000001
100100001000000000001
100000000010000000011
11000000000000000011
11111111111111111111
