NO ./assets/tatame_north_texture.xpm
SO ./assets/tatame_south_texture.xpm
WE ./assets/tatame_west_texture.xpm
EA ./assets/tatame_east_texture.xpm

F 220,100,0
C 225,30,0

    1111
  110001
 10000001
 1000N001
 10000001
  11000011
    111111
