NO ./assets/textures/novo1.xpm
SO ./assets/textures/novo2.xpm
WE ./assets/textures/parede7.xpm
EA ./assets/textures/chao1.xpm

F 30,30,20
C 0,0,0

1111111111111111111111
1000000000000000000001
1000000000000000000001
1000000000000000000001
1000000000000000000001
1000000000000000000001
1000000000000000000001
1000000000001000000001
1000000000N00000000001
1000000000000000000001
1000000000000000000001
1000000000000000000001
1000000000000000000001
1000000000000000000001
1000000000000000000001
1000000000000000000001
1000000000000000000001
1000000000000000000001
1000000000000000000001
1000000000000000000001
1111111111111111111111
