NO ./assets/textures/comb2/tatame_north_texture.xpm
SO ./assets/textures/comb2/tatame_south_texture.xpm
WE ./assets/textures/comb2/tatame_west_texture.xpm
EA ./assets/textures/comb2/tatame_east_texture.xpm

F 220,100,0
C 225,30,0

11111
10001
100W1
10001
11111
